barbarian   : evocation
bard        : abjuration, clerical, divination, enchantment
caveman     : transmutation
convict     : 
druid       : abjuration, conjuration, divination, enchantment, transmutation
explorer    : divination
gladiator   : 
gunslinger  : 
healer      : abjuration, clerical, enchantment, necromancy
hunter      : 
jester      : abjuration, divination, enchantment
knight      : evocation
miner       : abjuration, transmutation
monk        : clerical, conjuration
mystic      : divination, enchantment, evocation, transmutation
necromancer : abjuration, conjuration, divination, enchantment, necromancy, transmutation
ninja       : enchantment
paladin     : clerical
pirate      : 
priest      : clerical, conjuration, divination, necromancy
ranger      : divination
reaver      : necromancy
rogue       : abjuration, divination, transmutation
samurai     : clerical, evocation
shaman      : abjuration, divination, enchantment, evocation, necromancy
templar     : clerical
tinker      : abjuration, divination, enchantment, evocation, transmutation
tourist     : abjuration
trickster   : divination
valkyrie    : 
wizard      : abjuration, divination, enchantment, evocation, necromancy, transmutation
